S S S S S S S S S S
Z Z Z S S S S S S S
S S Z S S S S S S S
Z Z Z S S S S S S S
Z S S S Z Z Z S S S
Z Z S S Z S Z S S S
S Z Z Z Z S Z Z Z S
S S S S S S S S Z S
S S S S S S S S Z S
S S S S S S S S Z S
2 0
9 8
4
150
15
8 6 4 2