S Z S S S S S S S S
S Z S Z Z Z Z S S S
Z Z S Z S S Z S S S
Z S S Z S S Z Z Z S
Z Z Z Z S S S S Z S
S S S S S S S S Z S
Z Z Z Z Z Z Z Z Z S
Z S S S S S S S S S
Z Z Z Z Z Z Z S S S
S S S S S S Z S S S
1 1
9 6
4
80
15
7 5 2 1