S S S Z Z Z Z Z S S
Z Z S Z S S S Z S S
S Z S Z S Z Z Z S S
Z Z S Z S Z S S S S
Z S S Z S Z S S S S
Z Z Z Z S Z S S S S
S S S S S Z S S S S
Z Z Z Z Z Z S S S S
Z S S S S S S Z Z Z
Z Z Z Z Z Z Z Z S S
2 0
8 9
8
100
15
5 4 3 2 6 8 5 7